111111
100001
100011
1P0001
100CE1
111111