1111111111111111111111111111111111
100000000111000C00000C000001111001
100001111000000C00000C001000000001
1010010100100000101001000000010101
1010010010101010001001000100010101
1P0000000C00C000000000000E000000C1
1111111111111111111111111111111111