111111111111111111111111111111111111
101100111111111111111111111111111111
111000000000000000001000000000000011
111000000000000000010000000000000011
11111111100000000010000CCC1000C00011
11100CC00000000001000000000000000011
11100C00000000C01000000CCCC00C000011
11100CC000000001C0000000000000000011
11100C000000001000000001000000000101
11100C0000000100000C0000000000001001
11100CC0C011110001100000000000000001
11100C000000000001111000100000010001
101100P000000000000C0000010000100001
10E000100000000000000000001001000001
111111111111111111111111111111111111